31 65
#################################################################
#     #     #        #            #                             #
# ###   ### # #####  ### ###      #                             #
# #-# # #   ##    ##     # #      #                             #
# # # # # #A# # ###M ##### #      #                             #
# # ####### ###      #       #    #                             #
# # #   #   ##### # ## # # # #    #    ##  ##      #     ##     #
# # ##M## # #     # #  ##  # #    #    ##  ## #### #    #  #    #
# #                                    ###### #  # #    ####    #
# #########       #    # # # #    #    ##  ## #### #### #  #    #
#      #  #A#### ####### # # #    #                             #
#  ### #    #  #   M     # ###    #           ##  ##            #
#### # # ##### ##### ### # # #    #           ## ##             #
#      #   #       # # #   # #    #           ####              #
# #### # ##### ### # # ##### #    #           ## ##             #
#  #     # # # # # # # #     #    #           ##  ##            #
##   #####     # # # # # # ###    #           ##   ##           #
# ## #   ####### # # # # # # #    #                             #
# #  # ##        A     #   # #    #                             #
# # ## ## # ##### ### #### # #    #                             #
#    # ## # #   # # # ###  # #    #                             #
######    # ####  # # M # #  #    #  ##  ##  ###   #####  ##### #
#O########      # # # ##### ##    #  ##  ## ## ##  ##     ##    #
#        ### # #  # # A      #    #  ###### ###### ##     ##### #
####A#M#     # # #  # ###### #    #  ##  ## ##  ## ##     ##    #
#  # #   # ### # # ##    #   #    #  ##  ## ##  ## ###### ##### #
#  # ##### # # # # ### #### ##    #                             #
#  # #       #         #     #    #                             #
#    # ## # ## # ##### # ### #    #                             #
#    #########################                             +    #
#################################################################